//MAP CONVERTED BY dmm2tgm.py THIS HEADER COMMENT PREVENTS RECONVERSION, DO NOT REMOVE
"aa" = (
/obj/structure/grille,
/turf/simulated/floor/plating)
"ab" = (
/turf/simulated/wall/r_wall)
"ac" = (
/obj/machinery/atmospherics/unary/engine,
/turf/simulated/floor/plating)
"ad" = (
/obj/structure/shuttle/engine/heater{
	dir = 1
	},
/obj/structure/wall_frame,
/obj/structure/grille,
/obj/structure/window/phoronreinforced/full,
/turf/simulated/floor/plating)
"ae" = (
/obj/structure/shuttle/engine/heater{
	dir = 1
	},
/obj/structure/wall_frame,
/obj/structure/grille,
/obj/structure/window/phoronreinforced/full,
/turf/simulated/floor/plating)
"af" = (
/obj/machinery/atmospherics/pipe/simple/visible/red{
	dir = 6
	},
/turf/simulated/wall/r_wall)
"ag" = (
/obj/structure/shuttle/engine/heater{
	dir = 1
	},
/obj/structure/wall_frame,
/obj/structure/grille,
/obj/structure/window/phoronreinforced/full,
/obj/machinery/atmospherics/pipe/simple/visible/red{
	dir = 10
	},
/turf/simulated/floor/plating)
"ah" = (
/obj/machinery/alarm{
	dir = 4;
	locked = 0;
	pixel_x = -25
	},
/obj/machinery/atmospherics/unary/vent_pump/on,
/obj/effect/decal/cleanable/dirt,
/turf/simulated/floor/tiled/techfloor/grid)
"ai" = (
/obj/effect/decal/cleanable/dirt,
/obj/item/trash/raisins,
/obj/item/weapon/reagent_containers/food/drinks/glass2/fitnessflask,
/turf/simulated/floor/tiled/techfloor/grid)
"aj" = (
/obj/effect/decal/cleanable/dirt,
/obj/effect/decal/cleanable/dirt,
/turf/simulated/floor/tiled/techfloor/grid)
"ak" = (
/obj/machinery/power/terminal,
/obj/machinery/light/small{
	dir = 1
	},
/obj/structure/cable{
	d2 = 4;
	icon_state = "0-4"
	},
/obj/effect/decal/cleanable/dirt,
/obj/effect/decal/cleanable/dirt,
/turf/simulated/floor/tiled/techfloor/grid)
"al" = (
/obj/structure/sign/kiddieplaque{
	desc = "A plaque with information regarding this particular lifepod. It reads: 'Armalev Industries Skyfin-E, Exoplanetary Suvival Pod' there's a registry number, and an assigned mothership, but they've both been scratched to illegiblity.";
	name = "\improper Lifepod Plaque";
	pixel_y = 30
	},
/obj/structure/cable{
	d1 = 2;
	d2 = 8;
	icon_state = "2-8"
	},
/obj/effect/decal/cleanable/dirt,
/turf/simulated/floor/tiled/techfloor/grid)
"am" = (
/obj/machinery/atmospherics/pipe/simple/visible/cyan{
	dir = 6
	},
/obj/effect/decal/cleanable/dirt,
/obj/effect/decal/cleanable/dirt,
/turf/simulated/floor/tiled/techfloor/grid)
"an" = (
/obj/machinery/atmospherics/omni/filter,
/obj/effect/decal/cleanable/dirt,
/turf/simulated/floor/tiled/techfloor/grid)
"ao" = (
/obj/machinery/atmospherics/pipe/manifold/visible/red{
	dir = 4
	},
/obj/effect/decal/cleanable/dirt,
/obj/item/trash/tastybread,
/obj/item/weapon/reagent_containers/food/drinks/cans/speer,
/turf/simulated/floor/tiled/techfloor/grid)
"ap" = (
/obj/effect/decal/cleanable/dirt,
/obj/effect/decal/cleanable/dirt,
/obj/effect/decal/cleanable/vomit,
/obj/effect/decal/cleanable/filth,
/obj/structure/curtain/open/shower/engineering,
/obj/structure/hygiene/toilet{
	dir = 8
	},
/obj/item/weapon/storage/mirror{
	pixel_x = 27
	},
/obj/item/weapon/stock_parts/circuitboard/solar_control,
/turf/simulated/floor/tiled/techfloor/grid)
"aq" = (
/obj/machinery/atmospherics/pipe/simple/hidden/supply,
/obj/machinery/atmospherics/unary/vent_scrubber/on,
/obj/effect/decal/cleanable/dirt,
/obj/structure/closet/hydrant{
	pixel_x = -27
	},
/turf/simulated/floor/tiled/techfloor/grid)
"ar" = (
/obj/effect/floor_decal/industrial/outline/blue,
/obj/structure/cable{
	d1 = 4;
	d2 = 8;
	icon_state = "4-8"
	},
/obj/machinery/space_heater,
/obj/effect/decal/cleanable/dirt,
/turf/simulated/floor/tiled/techfloor)
"as" = (
/obj/effect/floor_decal/industrial/outline/blue,
/obj/machinery/power/apc{
	locked = 0;
	name = "south bump";
	pixel_y = -28
	},
/obj/structure/cable{
	d2 = 4;
	icon_state = "0-4"
	},
/obj/effect/decal/cleanable/dirt,
/obj/effect/decal/cleanable/filth,
/obj/machinery/portable_atmospherics/canister/carbon_dioxide,
/turf/simulated/floor/tiled/techfloor)
"at" = (
/obj/structure/cable{
	d2 = 8;
	icon_state = "0-8"
	},
/obj/effect/decal/cleanable/dirt,
/obj/machinery/power/smes/buildable{
	charge = 50000;
	inputting = 1;
	outputting = 1
	},
/turf/simulated/floor/tiled/techfloor)
"au" = (
/obj/machinery/atmospherics/pipe/manifold/visible/cyan{
	dir = 8
	},
/obj/structure/reagent_dispensers/fueltank,
/obj/effect/decal/cleanable/dirt,
/turf/simulated/floor/tiled/techfloor)
"av" = (
/obj/machinery/atmospherics/omni/filter,
/obj/effect/decal/cleanable/dirt,
/turf/simulated/floor/tiled/techfloor)
"aw" = (
/obj/machinery/atmospherics/pipe/manifold/visible/red{
	dir = 4
	},
/obj/effect/decal/cleanable/dirt,
/turf/simulated/floor/tiled/techfloor/grid)
"ax" = (
/obj/effect/wallframe_spawn/reinforced/hull,
/obj/machinery/door/firedoor,
/turf/simulated/floor/plating)
"ay" = (
/turf/simulated/wall)
"az" = (
/obj/machinery/atmospherics/binary/pump,
/turf/simulated/wall)
"aA" = (
/obj/machinery/door/firedoor,
/obj/machinery/door/airlock/engineering,
/obj/machinery/atmospherics/pipe/simple/hidden/supply,
/obj/machinery/atmospherics/pipe/simple/hidden/scrubbers,
/obj/effect/decal/cleanable/dirt,
/turf/simulated/floor/tiled/techfloor/grid)
"aB" = (
/obj/machinery/sleeper{
	dir = 4
	},
/obj/effect/floor_decal/industrial/outline/blue,
/turf/simulated/floor/tiled/techfloor/grid)
"aC" = (
/obj/machinery/door/firedoor,
/obj/machinery/door/airlock/engineering,
/obj/machinery/atmospherics/pipe/manifold/visible/red{
	dir = 4
	},
/obj/effect/decal/cleanable/dirt,
/turf/simulated/floor/tiled/techfloor/grid)
"aD" = (
/obj/machinery/atmospherics/pipe/simple/visible/red{
	dir = 5
	},
/turf/simulated/wall)
"aE" = (
/obj/machinery/sleeper{
	dir = 4
	},
/obj/effect/floor_decal/industrial/outline/blue,
/obj/effect/decal/cleanable/cobweb,
/turf/simulated/floor/tiled/techfloor/grid)
"aF" = (
/obj/effect/floor_decal/industrial/warning{
	dir = 8
	},
/obj/machinery/atmospherics/pipe/manifold/hidden/scrubbers{
	dir = 8
	},
/obj/machinery/atmospherics/pipe/manifold/hidden/supply{
	dir = 8
	},
/obj/effect/decal/cleanable/dirt,
/turf/simulated/floor/tiled/techfloor/grid)
"aG" = (
/obj/structure/closet/crate,
/obj/effect/floor_decal/industrial/hatch/orange,
/obj/item/device/scanner/gas,
/obj/item/weapon/stock_parts/circuitboard/unary_atmos/cooler,
/obj/item/weapon/stock_parts/circuitboard/unary_atmos/heater,
/obj/item/weapon/stock_parts/circuitboard/oxyregenerator,
/obj/item/weapon/tank/oxygen/red,
/obj/structure/cable,
/obj/item/stack/material/uranium/ten,
/obj/item/stack/material/uranium/ten,
/obj/item/stack/material/uranium/ten,
/obj/item/stack/material/uranium/ten,
/obj/item/stack/material/uranium/ten,
/obj/item/stack/material/uranium/ten,
/obj/item/stack/material/uranium/ten,
/obj/item/stack/material/uranium/ten,
/obj/item/stack/material/uranium/ten,
/obj/item/clothing/under/savage_hunter,
/obj/item/clothing/under/savage_hunter/female,
/obj/item/clothing/under/wetsuit,
/obj/effect/decal/cleanable/dirt,
/obj/item/trash/candy/proteinbar,
/obj/item/trash/liquidfood,
/obj/item/weapon/stock_parts/matter_bin/super,
/obj/item/weapon/stock_parts/circuitboard/biogenerator,
/obj/item/weapon/bedsheet/orange,
/obj/item/weapon/bedsheet/orange,
/obj/item/weapon/stock_parts/matter_bin/adv,
/obj/item/weapon/stock_parts/micro_laser/ultra,
/obj/item/weapon/reagent_containers/food/snacks/liquidfood,
/obj/item/stack/material/sandstone{
	amount = 50
	},
/turf/simulated/floor/tiled/techfloor)
"aH" = (
/obj/machinery/atmospherics/unary/vent_pump/on{
	dir = 8
	},
/obj/machinery/portable_atmospherics/canister/oxygen,
/obj/effect/decal/cleanable/dirt,
/turf/simulated/floor/tiled/techfloor)
"aI" = (
/obj/machinery/atmospherics/unary/tank/air,
/obj/effect/floor_decal/industrial/outline/blue,
/obj/effect/decal/cleanable/generic,
/turf/simulated/floor/tiled/techfloor)
"aJ" = (
/obj/effect/decal/cleanable/dirt,
/obj/effect/decal/cleanable/dirt,
/obj/effect/decal/cleanable/filth,
/obj/structure/curtain/open/shower/engineering,
/obj/structure/hygiene/shower{
	dir = 8;
	pixel_x = -6
	},
/turf/simulated/floor/tiled/techfloor/grid)
"aK" = (
/obj/machinery/atmospherics/pipe/simple/hidden/supply{
	dir = 4
	},
/obj/machinery/atmospherics/unary/vent_scrubber/on{
	dir = 8
	},
/obj/machinery/light/small{
	dir = 1
	},
/obj/item/weapon/mop,
/obj/effect/decal/cleanable/dirt,
/obj/item/trash/candy/proteinbar,
/obj/item/trash/liquidfood,
/obj/item/weapon/storage/box/detergent,
/obj/item/clothing/mask/plunger,
/turf/simulated/floor/tiled/techfloor)
"aL" = (
/obj/effect/floor_decal/industrial/warning{
	dir = 4
	},
/obj/machinery/atmospherics/pipe/manifold/visible/red{
	dir = 4
	},
/obj/effect/decal/cleanable/dirt,
/turf/simulated/floor/tiled/techfloor/grid)
"aM" = (
/obj/machinery/pipedispenser,
/obj/effect/floor_decal/industrial/outline/blue,
/obj/effect/decal/cleanable/generic,
/obj/effect/decal/cleanable/cobweb2,
/turf/simulated/floor/tiled/techfloor/grid)
"aN" = (
/obj/effect/floor_decal/industrial/warning{
	dir = 8
	},
/obj/machinery/atmospherics/pipe/simple/hidden/scrubbers,
/obj/machinery/atmospherics/pipe/manifold/hidden/supply{
	dir = 8
	},
/obj/effect/decal/cleanable/dirt,
/turf/simulated/floor/tiled/techfloor)
"aO" = (
/obj/machinery/atmospherics/pipe/simple/hidden/universal{
	dir = 4
	},
/obj/effect/decal/cleanable/dirt,
/turf/simulated/floor/tiled/techfloor)
"aP" = (
/obj/machinery/atmospherics/pipe/simple/hidden/cyan,
/obj/effect/decal/cleanable/dirt,
/obj/effect/decal/cleanable/filth,
/obj/item/solar_assembly,
/obj/item/solar_assembly,
/obj/item/solar_assembly,
/obj/item/solar_assembly,
/turf/simulated/floor/tiled/techfloor)
"aQ" = (
/obj/machinery/atmospherics/pipe/manifold/hidden,
/obj/effect/decal/cleanable/dirt,
/turf/simulated/floor/tiled/techfloor)
"aR" = (
/obj/machinery/fabricator,
/obj/effect/floor_decal/industrial/outline/blue,
/turf/simulated/floor/tiled/techfloor/grid)
"aS" = (
/obj/machinery/door/firedoor,
/obj/machinery/door/airlock/civilian,
/obj/machinery/atmospherics/pipe/simple/hidden/scrubbers,
/obj/machinery/atmospherics/pipe/simple/hidden/supply,
/turf/simulated/floor/tiled/techfloor)
"aT" = (
/obj/machinery/atmospherics/pipe/simple/hidden/cyan{
	dir = 9
	},
/obj/effect/decal/cleanable/dirt,
/obj/item/trash/tastybread,
/turf/simulated/floor/tiled/techfloor)
"aU" = (
/obj/machinery/atmospherics/pipe/simple/visible/red{
	dir = 6
	},
/obj/machinery/light/small{
	dir = 1
	},
/obj/effect/decal/cleanable/dirt,
/obj/effect/decal/cleanable/dirt,
/turf/simulated/floor/tiled/techfloor)
"aV" = (
/obj/machinery/atmospherics/binary/pump{
	dir = 8
	},
/obj/effect/decal/cleanable/dirt,
/obj/effect/decal/cleanable/dirt,
/turf/simulated/floor/tiled/techfloor)
"aW" = (
/obj/machinery/atmospherics/portables_connector{
	dir = 1
	},
/obj/machinery/portable_atmospherics/canister/empty,
/obj/effect/decal/cleanable/dirt,
/turf/simulated/floor/tiled/techfloor)
"aX" = (
/obj/effect/floor_decal/industrial/warning{
	dir = 4
	},
/obj/machinery/atmospherics/pipe/simple/visible/red,
/obj/effect/decal/cleanable/dirt,
/turf/simulated/floor/tiled/techfloor)
"aY" = (
/obj/machinery/door/firedoor,
/obj/machinery/door/airlock/civilian,
/obj/machinery/atmospherics/pipe/simple/hidden/universal,
/obj/effect/decal/cleanable/dirt,
/turf/simulated/floor/tiled/techfloor)
"aZ" = (
/obj/structure/bed/chair/shuttle/black,
/obj/structure/window/reinforced{
	dir = 8
	},
/obj/machinery/atmospherics/pipe/simple/hidden/scrubbers,
/obj/machinery/light{
	dir = 1
	},
/obj/effect/decal/cleanable/dirt,
/turf/simulated/floor/tiled/dark/monotile)
"ba" = (
/obj/machinery/atmospherics/pipe/manifold/hidden,
/obj/effect/decal/cleanable/dirt,
/obj/effect/decal/cleanable/dirt,
/turf/simulated/floor/tiled/techfloor)
"bb" = (
/obj/machinery/door/firedoor,
/obj/effect/wallframe_spawn/reinforced/hull,
/turf/simulated/floor/plating)
"bc" = (
/obj/structure/bed/chair/shuttle/black,
/obj/effect/decal/cleanable/dirt,
/turf/simulated/floor/tiled/dark/monotile)
"bd" = (
/obj/structure/table/steel_reinforced,
/obj/item/device/radio,
/obj/item/device/radio,
/obj/item/device/radio,
/obj/item/device/radio,
/obj/item/device/radio,
/obj/random/plushie,
/obj/effect/decal/cleanable/dirt,
/turf/simulated/floor/tiled/dark/monotile)
"be" = (
/obj/machinery/light/small{
	dir = 1
	},
/obj/structure/bed/chair,
/obj/structure/closet/hydrant{
	pixel_x = -27
	},
/obj/effect/decal/cleanable/dirt,
/turf/simulated/floor/tiled/dark)
"bf" = (
/obj/structure/bed/chair/shuttle/black,
/obj/structure/window/reinforced{
	dir = 4
	},
/obj/machinery/light{
	dir = 1
	},
/obj/effect/decal/cleanable/dirt,
/turf/simulated/floor/tiled/dark/monotile)
"bg" = (
/obj/machinery/atmospherics/pipe/simple/hidden/supply,
/obj/machinery/atmospherics/pipe/simple/hidden/scrubbers,
/obj/effect/decal/cleanable/dirt,
/obj/effect/decal/cleanable/dirt,
/turf/simulated/floor/tiled/techfloor)
"bh" = (
/obj/structure/window/reinforced{
	dir = 8
	},
/obj/effect/floor_decal/industrial/warning,
/obj/effect/decal/cleanable/dirt,
/turf/simulated/floor/tiled/dark)
"bi" = (
/obj/effect/floor_decal/industrial/warning,
/obj/effect/decal/cleanable/dirt,
/turf/simulated/floor/tiled/dark)
"bj" = (
/obj/structure/table/steel_reinforced,
/obj/machinery/recharger,
/obj/effect/decal/cleanable/dirt,
/obj/item/weapon/reagent_containers/food/drinks/glass2/coffeecup/metal,
/turf/simulated/floor/tiled/dark/monotile)
"bk" = (
/obj/machinery/atmospherics/unary/vent_pump/on,
/obj/effect/floor_decal/industrial/warning,
/obj/effect/decal/cleanable/dirt,
/obj/effect/decal/cleanable/dirt,
/turf/simulated/floor/tiled/dark)
"bl" = (
/obj/machinery/atmospherics/unary/vent_scrubber/on,
/obj/effect/floor_decal/industrial/warning,
/obj/effect/decal/cleanable/dirt,
/turf/simulated/floor/tiled/dark)
"bm" = (
/obj/effect/floor_decal/industrial/warning,
/obj/effect/decal/cleanable/dirt,
/obj/item/trash/candy/proteinbar,
/obj/item/trash/liquidfood,
/turf/simulated/floor/tiled/dark)
"bn" = (
/obj/structure/window/reinforced{
	dir = 4
	},
/obj/effect/floor_decal/industrial/warning,
/obj/effect/decal/cleanable/dirt,
/turf/simulated/floor/tiled/dark)
"bo" = (
/obj/machinery/atmospherics/pipe/simple/hidden/scrubbers,
/obj/effect/decal/cleanable/dirt,
/turf/simulated/floor/tiled/techfloor)
"bp" = (
/obj/machinery/atmospherics/pipe/simple/hidden/scrubbers,
/obj/effect/decal/cleanable/filth,
/turf/simulated/floor/tiled/techfloor)
"bq" = (
/obj/structure/closet/emcloset,
/obj/machinery/light/small{
	dir = 1
	},
/obj/item/weapon/crowbar,
/obj/item/weapon/crowbar,
/turf/simulated/floor/tiled/dark)
"br" = (
/obj/structure/table/steel_reinforced,
/obj/machinery/microwave,
/turf/simulated/floor/tiled/dark)
"bt" = (
/obj/machinery/atmospherics/pipe/simple/hidden/supply{
	dir = 4
	},
/obj/machinery/atmospherics/pipe/simple/hidden/scrubbers{
	dir = 4
	},
/obj/effect/decal/cleanable/dirt,
/turf/simulated/floor/tiled/techfloor)
"bu" = (
/obj/structure/table/steel_reinforced,
/obj/item/weapon/reagent_containers/food/condiment/small/saltshaker,
/obj/item/weapon/reagent_containers/food/condiment/small/peppermill,
/obj/effect/decal/cleanable/flour,
/obj/item/trash/candy/proteinbar,
/obj/machinery/reagentgrinder,
/obj/item/weapon/reagent_containers/food/condiment/small/sugar,
/turf/simulated/floor/tiled/dark)
"bv" = (
/obj/machinery/atmospherics/pipe/manifold/hidden/supply{
	dir = 8
	},
/obj/machinery/atmospherics/pipe/manifold/hidden/scrubbers{
	dir = 8
	},
/turf/simulated/floor/tiled/techfloor)
"bw" = (
/obj/machinery/atmospherics/pipe/manifold/hidden/scrubbers,
/obj/effect/decal/cleanable/dirt,
/turf/simulated/floor/tiled/techfloor)
"bx" = (
/obj/machinery/alarm{
	dir = 4;
	locked = 0;
	pixel_x = -25
	},
/obj/structure/bed/chair{
	dir = 1
	},
/obj/effect/decal/cleanable/dirt,
/turf/simulated/floor/tiled/dark)
"by" = (
/obj/machinery/atmospherics/pipe/simple/hidden/scrubbers{
	dir = 4
	},
/obj/effect/decal/cleanable/dirt,
/turf/simulated/floor/tiled/techfloor)
"bz" = (
/obj/machinery/atmospherics/pipe/simple/hidden/supply{
	dir = 10
	},
/obj/machinery/atmospherics/pipe/simple/hidden/scrubbers{
	dir = 10
	},
/turf/simulated/floor/tiled/techfloor)
"bA" = (
/obj/machinery/atmospherics/pipe/simple/hidden/scrubbers{
	dir = 9
	},
/obj/effect/decal/cleanable/dirt,
/turf/simulated/floor/tiled/techfloor)
"bB" = (
/obj/machinery/door/firedoor,
/obj/machinery/atmospherics/pipe/simple/hidden/supply,
/obj/machinery/atmospherics/pipe/simple/hidden/scrubbers,
/obj/machinery/door/airlock/engineering,
/turf/simulated/floor/tiled/techfloor)
"bC" = (
/obj/machinery/atmospherics/pipe/simple/hidden/supply{
	dir = 5
	},
/obj/machinery/atmospherics/pipe/simple/hidden/scrubbers{
	dir = 5
	},
/obj/effect/decal/cleanable/dirt,
/obj/effect/decal/cleanable/dirt,
/obj/effect/decal/cleanable/dirt,
/turf/simulated/floor/tiled/techfloor)
"bD" = (
/obj/effect/floor_decal/industrial/hatch/orange,
/turf/simulated/floor/tiled/techfloor)
"bE" = (
/obj/machinery/atmospherics/pipe/simple/hidden/supply{
	dir = 4
	},
/obj/machinery/atmospherics/pipe/simple/hidden/scrubbers{
	dir = 4
	},
/obj/effect/decal/cleanable/dirt,
/obj/effect/decal/cleanable/dirt,
/turf/simulated/floor/tiled/techfloor)
"bF" = (
/obj/machinery/atmospherics/pipe/simple/hidden/supply,
/obj/machinery/atmospherics/unary/vent_scrubber/on{
	dir = 1
	},
/turf/simulated/floor/tiled/techfloor)
"bG" = (
/obj/machinery/atmospherics/pipe/manifold/hidden/supply{
	dir = 4
	},
/obj/machinery/atmospherics/pipe/manifold/hidden/scrubbers{
	dir = 1
	},
/obj/effect/decal/cleanable/dirt,
/obj/effect/decal/cleanable/filth,
/turf/simulated/floor/tiled/techfloor)
"bH" = (
/obj/structure/reagent_dispensers/watertank,
/turf/simulated/floor/tiled/techfloor/grid)
"bI" = (
/obj/structure/closet/crate,
/obj/item/weapon/storage/briefcase/inflatable,
/obj/item/weapon/storage/briefcase/inflatable,
/obj/item/weapon/storage/briefcase/inflatable,
/obj/item/weapon/storage/briefcase/inflatable,
/obj/item/weapon/storage/briefcase/inflatable,
/obj/machinery/atmospherics/pipe/simple/hidden/supply,
/obj/machinery/atmospherics/unary/vent_scrubber/on{
	dir = 1
	},
/turf/simulated/floor/tiled/techfloor)
"bJ" = (
/obj/machinery/door/airlock/external{
	name = "escape pod airlock"
	},
/turf/simulated/floor/tiled/techfloor)
"bK" = (
/obj/effect/floor_decal/industrial/warning,
/obj/machinery/light/small,
/obj/effect/decal/cleanable/ash,
/obj/item/trash/cigbutt/cigarbutt,
/obj/effect/decal/cleanable/dirt,
/turf/simulated/floor/tiled/dark)
"bL" = (
/obj/effect/floor_decal/industrial/warning,
/obj/effect/decal/cleanable/dirt,
/obj/effect/decal/cleanable/dirt,
/turf/simulated/floor/tiled/techfloor)
"bM" = (
/obj/machinery/atmospherics/pipe/simple/hidden/supply{
	dir = 4
	},
/obj/machinery/atmospherics/pipe/simple/hidden/scrubbers{
	dir = 4
	},
/obj/structure/closet,
/obj/random/clothing,
/obj/random/clothing,
/obj/random/clothing,
/obj/random/clothing,
/obj/random/clothing,
/obj/random/clothing,
/obj/random/clothing,
/obj/random/clothing,
/obj/random/clothing,
/obj/random/gloves,
/obj/random/gloves,
/obj/random/hat,
/obj/random/hat,
/obj/random/hat,
/obj/random/hat,
/obj/random/hat,
/obj/item/clothing/under/color/orange,
/obj/item/clothing/under/color/orange,
/obj/item/clothing/under/color/blackjumpshorts,
/obj/item/clothing/under/color/black,
/obj/effect/decal/cleanable/dirt,
/turf/simulated/floor/tiled/dark)
"bN" = (
/obj/machinery/seed_extractor,
/turf/simulated/floor/tiled/techfloor/grid)
"bO" = (
/obj/effect/floor_decal/industrial/warning,
/obj/structure/table/steel_reinforced,
/obj/item/device/binoculars,
/obj/effect/decal/cleanable/dirt,
/obj/item/trash/candy/proteinbar,
/obj/item/weapon/reagent_containers/food/drinks/cans/speer,
/obj/effect/decal/cleanable/dirt,
/turf/simulated/floor/tiled/dark)
"bP" = (
/obj/machinery/portable_atmospherics/hydroponics,
/turf/simulated/floor/tiled/techfloor/grid)
"bQ" = (
/obj/machinery/atmospherics/pipe/simple/hidden/supply{
	dir = 4
	},
/obj/machinery/atmospherics/pipe/simple/hidden/scrubbers{
	dir = 4
	},
/obj/structure/closet,
/obj/random/clothing,
/obj/random/clothing,
/obj/random/clothing,
/obj/random/clothing,
/obj/random/clothing,
/obj/random/clothing,
/obj/random/clothing,
/obj/random/clothing,
/obj/random/gloves,
/obj/random/gloves,
/obj/random/hat,
/obj/random/hat,
/obj/random/hat,
/obj/random/hat,
/obj/random/hat,
/obj/item/clothing/under/color/orange,
/obj/item/clothing/under/color/orange,
/obj/item/clothing/under/color/blackjumpshorts,
/obj/item/clothing/under/color/black,
/obj/effect/decal/cleanable/dirt,
/turf/simulated/floor/tiled/dark)
"bR" = (
/obj/structure/table/steel_reinforced,
/obj/effect/decal/cleanable/dirt,
/obj/item/trash/tastybread,
/obj/item/device/geiger,
/obj/item/device/geiger,
/obj/effect/decal/cleanable/dirt,
/turf/simulated/floor/tiled/dark)
"bS" = (
/obj/effect/floor_decal/industrial/hatch/orange,
/obj/structure/table/rack,
/obj/item/clothing/suit/space/emergency,
/obj/item/clothing/head/helmet/space/emergency,
/obj/item/clothing/head/helmet/space/emergency,
/obj/item/clothing/suit/space/emergency,
/obj/item/weapon/tank/emergency/oxygen/double,
/obj/item/weapon/tank/emergency/oxygen/double,
/turf/simulated/floor/tiled/techfloor/grid)
"bT" = (
/obj/structure/closet/emcloset,
/obj/machinery/light/small,
/obj/item/weapon/crowbar,
/obj/item/weapon/crowbar,
/turf/simulated/floor/tiled/dark)
"bU" = (
/obj/machinery/atmospherics/pipe/simple/hidden/supply{
	dir = 4
	},
/obj/machinery/atmospherics/pipe/simple/hidden/scrubbers{
	dir = 4
	},
/obj/structure/closet,
/obj/random/clothing,
/obj/random/clothing,
/obj/random/clothing,
/obj/random/clothing,
/obj/random/clothing,
/obj/random/clothing,
/obj/random/clothing,
/obj/random/clothing,
/obj/random/gloves,
/obj/random/hat,
/obj/random/hat,
/obj/random/hat,
/obj/item/clothing/under/color/orange,
/obj/item/clothing/under/color/orange,
/obj/item/clothing/under/color/blackjumpshorts,
/obj/item/clothing/under/color/black,
/obj/effect/decal/cleanable/dirt,
/turf/simulated/floor/tiled/dark)
"bV" = (
/obj/effect/floor_decal/industrial/hatch/orange,
/obj/structure/table/rack,
/obj/item/clothing/suit/space/emergency,
/obj/item/clothing/suit/space/emergency,
/obj/item/clothing/head/helmet/space/emergency,
/obj/item/clothing/head/helmet/space/emergency,
/obj/item/weapon/tank/emergency/oxygen/double,
/obj/item/weapon/tank/emergency/oxygen/double,
/obj/machinery/light/small{
	dir = 8
	},
/turf/simulated/floor/tiled/techfloor/grid)
"bW" = (
/obj/structure/closet/crate/medical,
/obj/random/firstaid,
/obj/random/firstaid,
/obj/random/firstaid,
/obj/random/firstaid,
/obj/random/firstaid,
/obj/item/weapon/storage/firstaid/surgery,
/obj/item/weapon/storage/firstaid/stab,
/obj/item/weapon/storage/pill_bottle/antidexafen,
/obj/item/weapon/storage/pill_bottle/antidexafen,
/obj/item/weapon/storage/med_pouch/radiation,
/obj/item/weapon/storage/med_pouch/radiation,
/obj/item/weapon/storage/med_pouch/radiation,
/obj/item/weapon/storage/med_pouch/radiation,
/obj/item/weapon/storage/pill_bottle/assorted,
/turf/simulated/floor/tiled/techfloor/grid)
"bX" = (
/obj/structure/closet/crate,
/obj/random/handgun,
/obj/random/handgun,
/obj/random/handgun,
/obj/item/weapon/pickaxe,
/obj/item/weapon/pickaxe,
/obj/item/weapon/pickaxe,
/obj/item/stack/material/glass/fifty,
/obj/item/stack/material/glass/fifty,
/obj/item/stack/material/plasteel/fifty,
/obj/item/device/flashlight/lantern,
/obj/item/device/flashlight/lantern,
/obj/item/weapon/storage/box/glowsticks,
/obj/item/weapon/storage/box/glowsticks,
/obj/item/weapon/storage/box/glowsticks,
/obj/item/stack/material/steel/fifty,
/obj/item/stack/material/steel/fifty,
/obj/item/stack/material/steel/fifty,
/obj/random/toolbox,
/obj/random/toolbox,
/obj/random/toolbox,
/obj/random/toolbox,
/obj/item/stack/material/aluminium/fifty,
/obj/item/stack/material/plastic/fifty,
/turf/simulated/floor/tiled/techfloor/grid)
"bY" = (
/obj/structure/closet/crate/freezer/rations,
/obj/item/weapon/storage/bag/trash,
/obj/item/weapon/storage/bag/trash,
/obj/item/weapon/storage/box/donkpockets,
/obj/item/weapon/storage/box/donkpockets,
/obj/item/weapon/storage/fancy/egg_box,
/obj/item/weapon/storage/fancy/egg_box,
/obj/item/weapon/storage/fancy/egg_box,
/obj/item/weapon/reagent_containers/food/condiment/enzyme,
/obj/item/weapon/reagent_containers/food/drinks/milk,
/obj/item/weapon/reagent_containers/food/drinks/milk,
/obj/item/trash/liquidfood,
/obj/item/trash/liquidfood,
/obj/item/trash/liquidfood,
/obj/item/trash/liquidfood,
/obj/item/weapon/beartrap,
/obj/item/weapon/material/knife/kitchen/cleaver,
/obj/item/weapon/reagent_containers/food/snacks/liquidfood,
/obj/item/weapon/reagent_containers/food/snacks/liquidfood,
/obj/item/weapon/reagent_containers/food/snacks/liquidfood,
/obj/item/weapon/reagent_containers/food/snacks/liquidfood,
/obj/item/weapon/reagent_containers/food/snacks/liquidfood,
/obj/item/weapon/reagent_containers/food/snacks/liquidfood,
/obj/item/weapon/reagent_containers/food/snacks/liquidfood,
/obj/item/weapon/reagent_containers/food/snacks/liquidfood,
/turf/simulated/floor/tiled/techfloor/grid)
"bZ" = (
/obj/machinery/atmospherics/unary/vent_pump/on{
	dir = 1
	},
/obj/machinery/power/port_gen/pacman/super,
/obj/machinery/light/small,
/turf/simulated/floor/tiled/techfloor)
"ca" = (
/obj/structure/table/steel_reinforced,
/obj/item/weapon/storage/backpack/dufflebag/eng,
/obj/item/weapon/material/ashtray/bronze,
/obj/item/weapon/paper_bin,
/obj/item/weapon/reagent_containers/food/drinks/cans/speer,
/obj/effect/decal/cleanable/dirt,
/obj/item/weapon/pen,
/turf/simulated/floor/tiled/dark)
"cb" = (
/obj/item/device/oxycandle,
/obj/item/device/oxycandle,
/obj/item/device/oxycandle,
/obj/item/device/oxycandle,
/obj/item/device/oxycandle,
/obj/item/device/oxycandle,
/obj/item/device/oxycandle,
/obj/item/device/oxycandle,
/obj/item/device/oxycandle,
/obj/item/device/oxycandle,
/obj/item/device/oxycandle,
/obj/item/device/oxycandle,
/obj/item/device/oxycandle,
/obj/item/device/oxycandle,
/obj/item/device/oxycandle,
/obj/item/device/oxycandle,
/obj/item/device/oxycandle,
/obj/item/device/oxycandle,
/obj/structure/closet/crate,
/obj/machinery/atmospherics/unary/vent_pump/on{
	dir = 1
	},
/obj/machinery/light/small,
/turf/simulated/floor/tiled/techfloor)
"cc" = (
/obj/structure/table/steel_reinforced,
/obj/item/device/multitool,
/obj/item/weapon/screwdriver,
/obj/item/weapon/cell/device/high,
/obj/item/weapon/cell/device/high,
/obj/item/weapon/cell/crap,
/obj/item/weapon/storage/box/lights,
/obj/item/device/scanner/gas,
/obj/item/weapon/reagent_containers/food/drinks/cans/speer,
/obj/item/weapon/reagent_containers/food/drinks/cans/speer,
/obj/item/weapon/reagent_containers/food/drinks/cans/speer,
/obj/item/weapon/storage/box/monkeycubes,
/obj/item/weapon/reagent_containers/food/drinks/bottle/vodka,
/obj/item/weapon/reagent_containers/food/drinks/bottle/specialwhiskey,
/obj/item/weapon/tracker_electronics,
/obj/item/weapon/pen/blue,
/obj/item/weapon/pen/green,
/obj/item/weapon/pen/red,
/obj/item/weapon/storage/belt/utility/full,
/turf/simulated/floor/tiled/techfloor/grid)
"cd" = (
/obj/structure/closet/crate/large/hydroponics,
/obj/item/seeds/potatoseed,
/obj/item/seeds/potatoseed,
/obj/item/seeds/wheatseed,
/obj/item/seeds/wheatseed,
/obj/item/seeds/orangeseed,
/obj/item/seeds/orangeseed,
/obj/item/seeds/cornseed,
/obj/item/seeds/cornseed,
/obj/item/weapon/material/hatchet,
/obj/item/weapon/reagent_containers/glass/bucket,
/obj/item/weapon/material/minihoe,
/obj/item/weapon/plantspray/pests,
/obj/item/weapon/plantspray/pests,
/obj/item/weapon/plantspray/weeds,
/obj/item/seeds/poppyseed,
/obj/item/seeds/towermycelium,
/obj/item/seeds/glowshroom,
/obj/item/seeds/whitebeetseed,
/obj/item/weapon/storage/plants,
/obj/item/seeds/bananaseed,
/turf/simulated/floor/tiled/techfloor/grid)
"QI" = (
/obj/structure/hygiene/sink/kitchen,
/turf/simulated/wall/r_wall)

(1,1,1) = {"
aa
aa
aa
aa
ab
ab
ab
ab
ab
bb
ab
ab
ab
ab
ab
ab
"}
(2,1,1) = {"
ab
ab
ab
ab
ab
aE
aB
ay
be
ca
bx
bK
ax
bV
bS
ab
"}
(3,1,1) = {"
ac
ae
ah
aq
aA
aF
aN
aS
bg
bg
bC
bL
bJ
bD
bD
bJ
"}
(4,1,1) = {"
ab
ab
ai
as
ay
aK
aO
ay
aZ
bh
bE
bO
ab
ab
ab
ab
"}
(5,1,1) = {"
ac
ae
aj
ar
ay
aH
aV
ay
bc
bi
bt
bR
ay
bY
bX
ab
"}
(6,1,1) = {"
ab
ab
ak
at
ax
aI
ba
ax
bd
bk
bG
bv
bB
bF
bZ
ax
"}
(7,1,1) = {"
ab
ab
al
aG
ax
aI
aQ
ax
bj
bl
bw
bM
ay
bW
cc
ab
"}
(8,1,1) = {"
ac
ae
am
au
az
aP
aT
ay
bc
bm
by
bQ
ay
ay
ay
ab
"}
(9,1,1) = {"
ab
af
an
av
aD
aU
aW
ay
bf
bn
by
bU
ay
bH
bN
ab
"}
(10,1,1) = {"
ac
ag
ao
aw
aC
aL
aX
aY
bp
bo
bA
bz
bB
bI
cb
ax
"}
(11,1,1) = {"
ab
QI
ap
aJ
ay
aM
aR
ay
bq
bu
br
bT
ay
bP
cd
ab
"}
(12,1,1) = {"
aa
ab
ab
ab
ab
ab
ab
ab
ab
ax
ab
ab
ab
ab
ab
ab
"}
